################
##........##.#
#^.#..##.....#
###......###.#
#...##.......#
##.#....#....#
#..#.........#
#..###..##..##
#....#.......#
#.....####...,
####.........#
#@...........#
################